1  1  1  1  1  1  1  1  1  1  1  1  1  1  1  51  52  53  54  55  56  1  1  1  1  1  1  1  1  1  1  1  1  132  133  132  133  133  133  133  133  1  1  1  1  1  1  1  1  1  1  1  1  1  1  1  1  1  1  1  1  1  1  1  
1  1  1  1  1  1  1  1  1  1  6  7  8  1  1  61  62  63  74  65  66  1  1  1  1  1  1  1  1  1  185  1  1  132  133  132  132  133  143  143  143  1  1  1  1  1  1  1  1  1  1  1  88  1  1  1  1  1  1  57  58  1  1  1  
1  1  1  1  1  1  1  1  1  1  16  17  18  1  1  71  72  73  74  75  76  1  1  1  88  1  1  1  1  1  195  1  1  132  132  142  142  143  142  143  1  1  1  1  1  1  1  1  1  1  1  1  1  1  1  1  1  1  1  67  68  1  1  1  
1  1  1  1  185  1  1  1  1  1  26  27  28  1  1  71  72  73  74  75  76  1  1  1  1  1  1  1  1  1  1  1  1  142  132  132  132  142  142  143  1  1  1  1  1  1  1  11  12  13  1  42  43  44  45  1  1  1  1  77  78  1  1  1  
1  1  1  1  195  1  1  1  1  1  1  1  1  1  1  71  141  142  143  144  76  1  1  1  1  11  12  12  12  13  1  1  1  1  142  142  142  142  143  1  1  1  1  1  1  1  1  21  22  23  51  52  132  133  55  56  1  1  1  1  1  1  1  1  
1  88  1  1  1  1  1  11  12  13  1  1  1  1  1  71  141  142  143  144  76  1  1  1  1  21  22  22  22  23  1  1  1  1  1  1  88  1  1  1  1  1  57  58  1  1  1  31  32  33  61  62  142  143  65  66  1  1  1  1  1  1  1  1  
1  1  1  1  1  1  1  21  22  23  1  1  1  1  1  71  72  73  74  75  76  1  1  1  1  21  22  22  22  23  1  1  1  1  1  1  1  1  1  1  1  1  67  68  1  1  1  1  1  1  61  72  133  142  75  76  1  1  1  1  1  1  1  1  
1  1  1  1  57  58  1  31  32  33  1  1  1  1  1  71  72  73  74  75  76  1  1  1  1  21  22  22  22  23  11  12  12  12  12  12  12  13  1  1  1  1  77  78  1  1  1  1  1  51  52  72  143  142  143  86  1  1  1  1  1  1  1  1  
1  1  1  1  67  68  1  1  1  1  1  1  88  1  1  71  141  142  143  75  66  1  1  1  1  21  22  22  22  15  14  22  22  22  22  22  22  23  1  1  1  1  1  1  1  1  1  1  51  52  72  133  133  133  133  124  1  1  1  11  12  13  1  1  
1  1  1  1  77  78  1  1  185  1  1  1  1  1  1  71  145  146  147  75  76  1  1  1  1  21  22  22  22  25  24  22  22  22  22  22  22  23  1  1  1  88  1  1  1  1  1  51  52  72  133  132  133  143  143  65  56  1  1  21  22  23  1  1  
1  1  1  1  1  1  1  1  195  1  1  1  1  1  1  71  72  73  74  75  76  1  1  1  1  31  32  32  32  33  31  32  32  32  32  32  32  33  1  1  1  1  1  1  1  1  51  52  72  132  132  4  4  132  133  132  127  128  45  31  32  33  1  1  
1  1  1  1  1  1  1  1  1  1  1  1  1  1  1  71  145  73  74  75  76  1  1  1  1  1  1  1  1  11  12  13  1  1  1  1  1  1  1  57  58  1  1  1  1  1  61  62  132  132  142  4  4  4  4  4  133  143  55  56  1  1  1  1  
1  1  1  1  1  1  1  1  1  1  1  1  1  1  1  71  72  73  74  75  76  1  1  1  1  1  1  1  1  21  22  23  1  1  1  1  1  1  1  67  68  1  1  1  1  1  61  62  132  133  142  4  4  4  4  4  133  142  143  66  6  7  8  1  
1  1  1  1  1  1  1  1  1  1  57  58  1  1  1  61  141  142  143  144  66  1  6  7  8  1  1  1  1  31  32  33  1  1  1  1  1  1  185  77  78  1  1  1  11  12  61  72  132  133  4  4  4  4  4  132  132  133  143  66  16  17  18  1  
1  1  1  1  1  1  1  1  1  1  67  68  1  1  1  71  145  172  147  148  76  1  16  17  18  1  1  1  1  1  1  1  1  1  1  1  1  1  195  1  1  1  1  1  21  22  61  72  132  4  4  4  4  4  4  132  142  143  142  66  26  27  28  1  
1  1  1  1  1  1  1  1  1  1  77  78  1  1  1  81  171  172  74  174  86  1  26  27  28  1  1  1  1  1  1  1  41  42  43  44  45  46  1  1  1  1  1  1  31  32  71  62  132  4  142  4  4  132  4  142  142  143  142  76  1  1  1  1  
1  1  185  186  187  188  1  1  1  1  1  1  1  1  1  91  181  182  74  184  96  1  1  1  1  1  57  58  1  1  1  1  51  52  53  54  55  56  1  1  1  1  1  1  1  1  81  72  142  4  4  132  4  4  4  142  143  132  142  86  1  1  1  1  
1  1  195  196  197  198  1  1  1  1  1  1  1  1  1  101  191  192  193  194  106  1  1  1  1  1  67  68  1  1  1  1  61  62  63  63  65  66  1  1  1  57  58  1  1  1  61  62  132  142  4  144  145  132  132  132  132  73  158  96  1  1  1  1  
1  1  1  1  207  208  1  41  42  43  44  45  46  1  1  1  201  202  203  204  64  1  1  1  1  1  77  78  1  1  1  1  71  72  73  74  75  76  1  1  1  67  68  1  1  1  71  72  142  142  73  154  155  142  142  142  142  157  168  1  1  1  1  1  
1  1  1  1  217  218  1  51  52  53  54  55  56  1  1  1  211  212  213  214  1  1  1  1  1  1  1  1  1  1  1  1  81  171  172  173  174  86  1  1  1  77  78  97  98  1  81  62  132  133  134  164  165  192  156  157  193  167  178  1  1  1  1  1  
1  1  1  1  11  12  13  61  62  63  63  65  66  1  1  1  1  1  1  1  1  1  1  1  1  1  1  1  1  1  1  1  91  181  182  183  184  96  1  1  1  1  1  107  108  1  61  72  74  133  144  76  201  202  166  203  167  177  1  1  1  1  1  1  
1  1  1  1  21  22  23  71  72  73  74  75  76  1  1  1  1  1  1  1  1  1  1  1  88  1  1  1  1  1  1  1  101  191  192  193  194  106  1  1  1  1  1  117  118  1  71  62  74  133  85  86  211  212  176  213  177  106  1  1  1  1  1  1  
1  1  88  1  31  32  33  81  171  172  173  174  86  1  1  1  186  1  1  1  1  1  1  1  1  1  1  1  1  1  1  1  1  201  202  203  204  1  1  1  1  1  1  1  1  1  81  72  144  158  95  96  1  1  1  11  12  13  1  1  1  1  1  1  
1  1  1  1  1  1  1  91  181  182  183  184  96  1  1  1  196  1  1  1  1  1  1  1  1  1  1  1  1  1  1  1  1  211  212  213  214  1  1  1  57  58  1  1  1  1  61  62  134  164  105  106  1  1  1  21  22  23  1  1  57  58  1  1  
1  1  1  1  1  1  1  101  191  192  193  194  106  1  1  1  1  1  1  42  43  44  45  1  42  45  1  1  1  1  1  1  1  1  1  1  1  1  1  1  67  68  1  1  1  1  61  72  144  66  1  1  1  1  1  31  32  33  1  1  67  68  1  1  
1  1  1  1  1  1  1  1  201  202  203  204  1  1  1  1  1  1  42  121  122  123  124  125  126  127  128  56  1  1  97  98  1  1  1  1  1  1  1  1  77  78  1  1  1  1  61  62  134  76  1  1  1  88  1  1  1  1  1  1  77  78  1  1  
1  1  1  1  1  1  1  1  211  212  213  214  1  1  1  1  1  1  61  131  132  133  134  135  136  137  138  66  1  1  107  108  1  1  1  1  1  1  1  1  1  1  1  1  1  1  61  72  144  76  1  1  1  1  1  42  43  44  45  1  42  45  1  31  
1  1  97  98  1  1  1  1  1  1  1  1  1  1  1  1  1  1  71  141  142  143  144  82  83  84  85  76  1  1  117  118  1  1  1  1  1  224  1  1  1  1  1  1  1  1  61  62  134  66  1  1  1  1  42  121  122  123  124  125  126  127  128  56  
1  1  107  108  1  1  1  1  88  1  1  1  57  58  1  1  1  1  81  155  156  157  158  92  93  94  95  86  1  1  1  1  1  1  1  1  1  224  1  1  1  1  1  1  224  1  71  72  144  76  1  1  1  1  61  131  132  133  134  135  136  137  138  66  
1  1  117  118  1  1  1  1  1  1  1  1  67  68  1  1  1  1  101  165  166  167  168  102  103  104  105  96  1  1  185  1  1  1  1  1  1  1  1  1  11  12  13  1  1  1  81  62  133  55  56  1  1  1  71  141  142  143  144  82  83  84  85  76  
1  1  1  1  1  1  1  1  1  1  1  1  77  78  1  1  1  1  12  175  176  177  178  1  11  12  12  13  1  1  195  1  1  1  57  58  1  1  1  1  21  22  23  1  1  51  52  72  133  65  66  1  1  1  81  155  156  157  158  92  93  94  95  86  
1  1  1  11  12  13  1  1  1  1  1  1  1  1  1  1  1  1  1  1  1  1  1  1  21  22  22  23  1  1  1  1  1  1  67  68  1  1  1  1  31  32  33  1  1  61  62  133  143  134  66  1  1  1  101  165  166  167  168  102  103  104  105  96  
1  1  1  21  22  23  1  1  1  1  1  1  1  1  1  1  1  1  1  1  1  11  12  13  21  22  22  23  1  1  1  1  1  1  77  78  1  1  1  1  1  1  1  1  1  61  72  133  63  144  66  1  1  1  1  175  176  177  178  1  1  1  1  1  
1  1  1  31  32  33  1  1  1  1  1  185  1  1  1  1  1  1  1  1  1  21  22  23  21  22  22  23  1  1  1  1  1  1  1  1  1  1  1  1  1  1  1  1  1  61  62  133  63  134  66  1  1  1  11  12  13  1  1  1  1  1  1  1  
1  1  1  1  1  1  1  1  1  1  1  195  1  1  1  1  57  58  1  1  1  31  32  33  21  22  22  23  1  1  1  1  1  1  1  1  1  1  1  1  1  57  58  1  1  61  62  133  63  134  66  1  1  1  21  22  23  1  1  1  1  1  1  1  
1  1  1  1  1  1  1  1  1  1  1  185  1  1  1  1  67  68  1  1  1  1  1  1  21  22  22  23  1  1  1  1  1  1  1  207  1  1  1  1  1  67  68  1  1  71  72  133  63  144  76  1  1  1  31  32  33  1  1  57  58  1  1  1  
1  1  1  1  1  57  58  1  1  1  1  195  1  1  1  1  77  78  1  1  1  1  1  1  21  22  22  23  1  1  11  12  13  1  1  217  1  1  1  1  1  77  78  1  1  81  82  83  84  85  86  1  1  1  224  1  1  1  1  67  68  1  1  1  
6  7  8  1  1  67  68  1  1  1  1  1  1  1  1  1  1  1  1  1  6  7  8  1  31  32  32  33  1  1  21  22  23  1  1  1  1  1  1  1  1  1  1  1  1  91  92  93  94  95  96  1  1  1  1  1  1  1  1  77  78  1  1  1  
16  17  18  1  1  77  78  1  1  1  88  1  1  1  11  12  13  1  1  1  16  17  18  1  1  1  1  1  1  1  21  22  23  1  1  1  1  1  1  1  1  11  12  13  1  101  102  103  104  105  106  1  1  1  1  1  1  1  1  1  1  1  1  1  
26  27  28  1  1  1  1  1  1  1  1  1  1  1  21  22  23  1  1  1  26  27  28  1  1  1  1  1  1  1  31  32  33  1  1  57  58  1  1  1  1  21  22  23  1  1  1  1  1  1  1  1  1  1  1  1  1  1  1  1  11  12  12  13  
1  1  1  1  1  1  42  43  44  45  1  42  45  1  31  32  33  1  1  1  1  1  1  1  1  57  58  1  1  207  1  1  1  1  1  67  68  1  1  1  1  31  32  33  1  1  1  1  1  1  1  1  1  1  1  1  1  1  1  1  21  22  22  23  
1  1  1  1  1  42  121  122  123  124  125  126  127  128  56  1  1  1  97  98  1  1  1  1  1  67  68  1  1  217  1  1  1  1  1  77  78  1  1  1  1  1  1  1  1  1  1  42  43  44  45  1  42  45  1  1  1  1  1  1  21  22  22  23  
1  88  1  1  1  61  131  132  133  134  135  136  137  138  66  1  1  1  107  108  1  1  1  1  1  77  78  1  1  1  1  1  1  1  1  1  1  1  1  1  1  1  1  1  1  1  42  121  122  123  124  125  126  127  128  56  1  1  1  1  21  22  22  23  
1  1  1  1  1  71  141  142  143  144  82  83  84  85  76  1  1  1  117  118  1  1  1  1  88  1  1  1  1  1  1  1  87  88  88  1  1  1  1  1  1  207  1  1  1  1  61  131  132  133  134  135  136  137  138  66  1  1  1  1  21  22  22  23  
1  1  1  1  1  81  155  156  157  158  92  93  94  95  86  1  1  1  42  43  44  45  1  42  45  1  1  1  1  1  1  1  1  1  1  1  1  1  97  98  1  217  1  1  1  1  71  141  142  143  144  82  83  84  85  76  11  12  13  1  21  22  22  23  
1  1  1  1  1  101  165  166  167  168  102  103  104  105  96  1  1  42  121  122  123  124  125  126  127  128  56  1  1  1  1  1  1  1  1  1  1  1  107  108  1  1  1  1  1  1  81  155  156  157  158  92  93  94  95  86  21  22  23  1  21  22  22  23  
1  1  1  1  1  1  175  176  177  178  41  42  43  44  45  46  1  61  131  132  133  134  135  136  137  138  66  1  1  1  1  1  1  1  1  1  1  1  117  118  41  42  43  44  45  46  101  165  166  167  168  102  103  104  105  96  31  32  33  1  21  22  22  23  
1  1  1  1  1  1  1  1  1  1  51  52  53  54  55  56  1  71  141  142  143  144  82  83  84  85  76  1  1  1  1  1  1  1  1  1  1  1  1  1  51  52  53  54  55  56  1  175  176  177  178  1  1  1  1  1  88  1  1  1  21  22  22  23  
1  1  1  1  1  1  6  7  8  1  61  62  63  63  65  66  1  81  155  156  157  158  92  93  94  95  86  1  1  1  1  1  1  1  1  1  1  1  1  1  61  62  63  63  65  66  1  1  1  1  1  1  1  1  1  1  1  1  1  11  14  22  22  23  
1  97  98  1  1  1  16  17  18  1  71  72  73  74  75  76  1  101  165  166  167  168  102  103  104  105  96  1  1  1  1  1  1  1  1  1  1  11  12  13  71  72  73  74  75  76  1  88  88  1  1  1  1  207  1  1  1  1  1  21  22  22  22  23  
1  107  108  1  1  1  26  27  28  1  81  171  172  173  174  86  1  1  175  176  177  178  1  1  11  12  12  13  1  1  1  1  1  1  1  1  1  21  22  23  81  171  172  173  174  86  1  1  1  1  1  1  1  217  1  1  1  1  11  14  22  22  25  33  
1  117  118  1  1  88  1  1  1  1  91  181  182  183  184  96  1  1  1  1  1  1  1  1  21  22  22  23  1  1  42  43  44  45  1  42  45  31  32  33  91  181  182  183  184  96  1  1  1  1  1  1  1  1  1  1  1  11  14  22  22  25  33  1  
1  1  1  1  1  1  1  1  1  1  101  191  192  193  194  106  1  1  1  1  1  1  1  1  21  22  22  23  1  42  121  122  123  124  125  126  127  128  56  1  101  191  192  193  194  106  1  1  1  1  1  1  11  12  12  12  12  14  22  22  25  33  1  1  
1  1  1  1  1  1  1  1  1  1  1  201  202  203  204  1  1  1  1  1  97  98  1  1  21  22  22  23  1  61  131  132  133  134  135  136  137  138  66  1  1  201  202  203  204  11  12  12  12  12  12  12  14  22  22  22  22  22  25  32  33  1  1  1  
1  1  11  12  12  13  1  1  1  1  1  211  212  213  214  1  1  1  1  1  107  108  1  1  21  22  22  23  1  71  141  142  143  144  82  83  84  85  76  1  1  211  212  213  214  21  22  22  22  22  22  22  22  22  25  32  32  32  33  6  7  8  1  1  
1  1  21  22  22  12  12  12  12  12  12  12  12  12  13  1  1  1  1  1  117  118  1  1  21  22  22  23  1  81  155  156  157  158  92  93  94  95  86  41  42  43  44  45  46  21  22  22  22  22  22  22  22  22  23  1  1  1  1  16  17  18  1  1  
1  1  21  22  22  22  22  22  22  22  22  22  22  22  12  12  12  12  12  12  12  12  12  12  14  22  22  23  1  101  165  166  167  168  102  103  104  105  96  51  52  53  54  55  56  31  32  32  32  32  32  32  32  32  33  1  1  1  1  26  27  28  1  1  
1  88  21  22  22  22  22  22  22  22  22  22  22  22  22  22  22  22  22  22  22  22  22  22  22  22  25  33  1  1  175  176  177  178  1  1  1  1  1  61  62  63  63  65  66  1  1  1  1  88  1  1  6  7  8  1  1  1  1  1  1  1  1  1  
1  1  31  32  32  32  32  32  32  32  32  32  32  24  22  22  22  22  22  22  22  22  22  22  22  22  23  1  1  1  1  1  1  1  1  1  1  1  1  71  72  73  74  75  76  1  1  1  1  1  1  1  16  17  18  1  1  1  1  1  1  1  1  1  
1  1  1  1  6  7  8  6  7  8  1  1  1  31  32  32  32  32  32  32  32  32  32  32  32  32  33  1  6  7  8  1  1  1  1  1  97  98  1  81  171  172  173  174  86  1  1  1  1  1  1  1  26  27  28  1  1  1  1  1  1  1  1  1  
1  1  1  1  16  17  18  16  17  18  1  1  97  98  1  1  88  1  1  6  7  8  1  1  1  1  1  1  16  17  18  1  1  1  1  1  107  108  1  91  181  182  183  184  96  1  1  1  1  1  1  1  1  1  1  1  1  1  1  1  1  1  1  1  
1  1  1  1  26  27  28  26  27  28  1  1  107  108  1  1  1  1  1  16  17  18  1  1  1  1  1  1  26  27  28  1  1  1  1  1  117  118  1  101  191  192  193  194  106  1  1  1  1  1  1  1  1  1  1  1  1  1  1  1  1  1  1  1  
1  1  1  1  1  1  1  1  1  1  1  1  117  118  1  1  1  1  1  26  27  28  1  1  1  1  1  1  1  1  1  1  1  1  1  1  1  1  1  1  201  202  203  204  1  1  1  1  1  1  1  1  1  1  1  1  1  1  1  1  1  1  205  206  
1  1  1  1  1  1  1  1  1  1  1  1  1  1  1  1  1  1  1  1  1  1  1  1  1  1  1  1  1  1  1  1  1  1  1  1  1  1  1  1  211  212  213  214  1  1  1  1  1  1  1  1  1  1  1  1  1  1  1  1  1  1  215  216