58 77 78 77 78 77 78 77 78 67 68 77 78 77 78 77 78 77 78 57 58 77 78 77 78 77 78 77 78 57 58 1 42 43 44 44 43 43 45 77 78 77 78 77 78 16 17 18 26 27 28 77 78 26 27 28 16 17 18 77 78 77 78 77 
68 1 1 1 1 57 58 1 1 77 78 1 1 1 1 1 1 1 1 67 68 1 1 1 57 58 1 1 1 67 68 51 52 53 54 53 53 54 55 56 11 12 13 57 58 26 27 28 1 1 1 1 1 1 1 1 26 27 28 57 58 1 1 57 
78 1 1 1 1 67 68 1 1 1 1 1 1 1 1 1 1 57 58 77 78 1 1 1 67 68 6 7 8 77 78 61 62 63 73 74 63 63 65 66 21 22 23 67 68 1 1 1 1 1 1 57 58 1 1 1 1 1 1 67 68 1 1 67 
57 58 1 1 1 77 78 1 1 6 7 8 1 1 1 1 1 67 68 1 1 1 1 1 77 78 16 17 18 57 58 71 72 63 63 63 73 74 75 76 21 22 23 77 78 1 1 1 1 1 1 67 68 1 1 1 1 1 1 77 78 1 1 77 
67 68 1 1 1 1 1 1 1 16 17 18 1 1 1 1 1 77 78 1 1 1 1 1 57 58 26 27 28 67 68 61 62 63 73 74 63 63 65 76 21 22 23 1 1 1 1 1 1 1 1 77 78 1 1 1 1 1 1 1 1 1 1 57 
77 78 1 1 1 1 1 1 1 26 27 28 1 1 1 1 1 1 1 1 1 1 1 1 67 68 1 1 1 77 78 71 72 73 74 73 74 63 75 66 21 22 23 1 1 1 1 1 1 1 1 1 1 1 1 1 1 1 1 1 1 1 1 67 
58 1 1 57 58 1 1 1 1 1 1 1 1 11 12 13 1 1 1 57 58 1 1 1 77 78 1 1 1 1 1 81 82 83 84 84 83 84 85 86 21 22 23 1 42 43 44 44 43 43 43 44 44 43 43 44 44 43 43 45 1 1 1 77 
68 1 1 67 68 1 1 1 1 1 1 1 1 21 22 23 1 1 1 67 68 1 1 1 1 1 1 1 1 1 1 91 92 93 94 94 93 94 95 96 21 22 23 51 52 53 54 53 53 54 53 54 53 53 54 54 53 53 54 55 56 1 1 57 
78 1 1 77 78 1 1 1 1 1 1 1 1 21 22 23 1 1 1 77 78 1 1 1 1 1 1 1 1 1 1 101 102 103 104 102 103 104 105 106 21 22 23 61 62 63 73 74 63 63 63 73 74 63 63 73 74 63 63 65 66 1 1 67 
8 1 1 1 1 1 1 1 1 1 1 1 1 21 22 23 1 1 1 1 1 1 1 1 1 1 1 1 1 1 1 1 1 1 1 1 1 1 1 11 14 22 23 71 72 63 63 63 73 74 63 63 63 73 74 63 63 73 74 75 76 1 1 77 
18 1 1 1 1 1 57 58 1 1 1 1 1 21 22 23 1 1 1 1 1 11 12 12 13 1 1 11 12 12 12 13 1 1 57 58 1 1 1 21 25 24 23 61 62 63 73 74 63 63 63 73 74 63 63 73 74 63 63 65 76 1 57 58 
28 1 1 1 1 1 67 68 1 1 6 7 8 31 32 33 1 1 1 1 11 22 22 22 15 13 11 14 22 25 24 23 1 1 67 68 6 7 8 21 15 14 23 71 72 73 74 73 74 63 73 74 73 74 63 74 73 74 63 75 66 1 67 68 
7 8 1 1 1 1 77 78 1 1 16 17 18 1 1 1 1 1 1 11 22 22 22 22 22 22 22 22 22 15 14 23 1 1 77 78 16 17 18 21 22 22 23 81 82 83 84 84 83 84 83 84 84 83 84 84 84 83 84 85 86 1 77 78 
17 18 57 58 1 1 1 1 1 1 26 27 28 1 1 1 1 1 11 22 22 22 22 22 22 25 24 22 22 22 25 33 1 1 1 1 26 27 28 21 22 22 23 91 92 93 94 94 93 94 93 94 94 93 94 94 94 93 94 95 96 1 1 57 
27 28 67 68 1 1 1 1 1 1 1 1 1 1 1 1 1 11 22 22 22 22 22 22 22 15 14 22 22 25 33 1 1 1 1 1 1 1 1 31 24 22 23 101 102 103 104 102 103 104 103 104 102 103 104 104 102 103 104 105 106 1 6 7 
8 1 77 78 1 1 1 1 1 1 1 1 1 1 1 1 11 22 22 22 25 24 22 22 22 22 22 22 25 33 1 1 1 1 1 1 1 1 1 1 31 32 33 1 1 1 1 1 11 12 12 12 12 12 12 12 12 12 12 12 13 1 16 17 
18 1 1 1 1 1 1 1 1 1 57 58 1 1 1 11 22 22 22 22 15 14 22 22 22 22 22 25 33 1 1 1 1 1 1 57 58 1 1 6 7 8 1 1 1 1 57 58 21 22 22 25 24 22 22 22 22 22 22 22 23 1 26 27 
7 8 1 1 1 1 1 1 1 1 67 68 1 1 11 22 22 25 24 22 22 22 22 22 22 22 25 33 1 1 1 1 1 1 1 67 68 1 1 16 17 18 1 1 1 1 67 68 21 22 22 15 14 22 22 22 22 22 22 22 23 6 7 8 
17 18 1 1 1 1 1 1 1 1 77 78 1 1 21 22 22 15 14 22 22 25 24 22 22 25 33 1 1 1 1 1 1 1 1 77 78 1 1 26 27 28 1 6 7 8 77 78 31 32 32 32 32 32 32 32 32 32 32 32 33 16 17 18 
27 28 1 1 1 1 1 1 1 1 1 1 1 1 21 22 22 22 22 22 22 15 14 22 25 33 1 1 1 1 1 1 1 1 6 7 8 1 1 1 1 1 1 16 17 18 1 42 43 44 44 43 43 45 1 1 1 1 1 1 1 26 27 28 
57 58 57 58 1 1 1 6 7 8 1 1 1 1 21 22 22 22 22 22 22 22 22 22 23 1 11 12 12 12 12 12 12 13 16 17 18 1 1 1 1 1 1 26 27 28 51 52 53 54 53 53 54 55 56 1 1 1 6 7 8 1 1 57 
67 68 67 68 1 1 1 16 17 18 1 1 1 1 21 22 22 22 22 22 22 25 32 32 33 1 21 22 22 22 25 24 22 23 26 27 28 1 1 1 1 1 1 1 1 1 61 62 63 73 74 63 63 65 66 1 1 1 16 17 18 1 1 67 
77 78 77 78 1 1 1 26 27 28 1 1 1 1 21 22 22 22 22 22 25 33 1 1 1 1 21 22 22 22 15 14 22 23 1 1 1 1 1 1 1 1 1 1 1 1 71 72 63 63 63 73 74 75 76 1 1 1 26 27 28 1 1 77 
58 1 1 1 1 1 1 1 1 1 1 1 1 1 31 32 32 32 32 32 33 1 1 1 1 1 21 22 22 22 22 22 22 23 1 1 1 1 6 7 8 1 1 1 1 1 61 62 63 73 74 63 63 65 76 1 1 1 1 1 1 1 1 57 
68 1 1 1 1 1 1 1 1 1 1 1 1 1 1 1 1 1 1 1 1 1 1 1 1 1 31 32 32 32 32 32 32 33 1 1 1 1 16 17 18 1 1 1 1 1 71 72 73 74 73 74 63 75 66 1 1 1 1 1 1 1 1 67 
78 1 1 1 1 1 1 1 1 42 43 43 44 43 44 44 43 44 43 43 43 43 44 43 43 43 43 44 44 44 43 43 43 44 45 1 1 1 26 27 28 1 1 1 1 1 61 62 63 73 74 63 63 75 66 1 1 1 1 1 1 1 1 77 
57 58 1 1 1 1 1 1 51 52 53 53 54 53 54 54 53 54 53 53 53 53 54 53 53 53 53 54 54 54 53 53 53 54 55 56 1 1 1 1 1 1 1 1 1 1 71 72 63 73 74 63 63 65 76 1 1 1 1 1 1 1 57 58 
67 68 1 1 1 1 1 1 52 62 63 63 63 63 63 63 63 63 63 63 63 63 63 63 63 63 63 63 63 63 63 63 63 63 63 55 56 1 1 1 1 1 57 58 1 1 61 62 63 63 63 73 74 75 76 1 1 1 1 1 1 1 67 68 
77 78 1 1 1 1 1 52 62 63 63 74 74 74 74 74 74 74 74 74 74 74 74 74 74 74 74 74 74 74 63 63 63 63 63 63 55 56 1 1 1 1 67 68 1 1 71 72 63 73 74 63 63 65 66 1 1 1 6 7 8 1 77 78 
8 1 1 1 1 51 52 62 63 63 63 63 63 142 143 141 142 146 147 143 146 142 143 147 74 146 147 63 63 63 63 63 63 63 63 63 65 66 1 1 1 1 77 78 1 1 61 62 73 74 73 74 63 75 66 1 1 1 16 17 18 1 57 58 
18 1 1 1 1 61 72 141 142 143 144 142 143 147 148 146 147 143 142 143 146 147 146 147 142 143 146 142 146 147 143 146 147 146 147 74 75 76 1 1 1 1 1 1 1 1 71 72 63 73 74 63 63 65 66 57 58 1 26 27 28 1 67 68 
28 1 1 1 1 71 72 142 143 142 143 146 147 146 142 143 142 142 143 142 146 146 147 146 142 142 143 142 143 142 143 143 147 146 147 147 153 66 1 1 1 1 1 1 1 1 71 72 63 63 63 73 74 75 76 67 68 1 1 1 1 1 77 78 
58 1 1 1 1 81 82 152 83 83 83 83 83 83 83 83 83 83 83 83 83 83 83 83 83 83 83 83 83 83 83 83 83 83 153 152 85 86 1 1 1 1 1 1 1 1 61 62 63 73 74 63 63 65 76 77 78 1 1 1 1 1 57 58 
68 1 1 1 1 91 92 92 93 93 94 94 94 93 95 93 93 94 95 94 94 92 94 92 95 94 94 94 95 94 94 94 94 94 94 95 95 96 1 1 1 57 58 1 1 1 71 72 73 74 73 74 63 75 66 1 1 1 1 6 7 8 67 68 
78 1 1 1 1 101 102 103 104 105 103 104 105 103 104 105 103 104 105 103 104 105 103 104 105 103 104 105 103 104 105 103 104 105 103 104 105 106 1 1 1 67 68 1 1 1 81 82 83 84 84 83 84 85 86 1 1 1 1 16 17 18 77 78 
7 8 1 1 1 1 1 1 1 1 1 1 1 1 11 12 12 12 12 12 12 12 13 1 21 12 12 12 12 12 12 12 12 12 13 1 1 1 1 1 1 77 78 1 1 1 91 92 93 94 94 93 94 95 96 1 1 1 1 26 27 28 6 7 
17 18 1 1 1 1 1 1 1 1 1 1 1 1 31 24 22 22 22 22 22 22 15 12 14 22 22 22 25 32 32 32 24 22 23 1 1 1 1 1 1 1 1 1 1 1 101 102 103 104 102 103 104 105 106 1 1 1 1 1 1 1 16 17 
27 28 1 1 1 1 1 1 1 1 1 1 1 1 1 31 24 22 22 22 25 24 22 22 22 22 22 22 23 6 7 8 21 22 23 1 1 1 1 1 1 1 1 1 1 1 1 1 1 1 1 1 1 1 1 1 1 1 1 1 1 1 26 27 
8 1 1 1 1 1 1 1 1 1 1 1 1 1 1 1 31 24 24 22 15 14 22 22 22 22 22 22 23 16 17 18 21 22 23 1 1 1 1 1 1 1 1 1 1 1 1 1 1 1 1 1 1 1 1 1 1 1 1 1 1 1 57 58 
18 1 1 1 1 1 57 58 1 1 1 6 7 8 1 1 1 1 31 24 22 22 22 22 22 22 22 22 23 26 27 28 21 22 23 6 7 8 1 1 1 1 1 1 6 7 8 1 1 1 1 42 43 44 44 43 43 45 1 1 1 1 67 68 
28 1 1 1 1 1 67 68 1 1 1 16 17 18 1 1 1 1 1 31 24 22 22 22 22 22 22 22 15 12 12 12 14 22 23 16 17 18 1 1 1 1 1 1 16 17 18 1 1 1 51 52 53 54 53 53 54 55 56 1 1 1 77 78 
58 1 1 1 1 1 77 78 1 1 1 26 27 28 1 1 1 1 1 1 31 32 32 24 22 22 22 22 22 22 22 22 22 25 33 26 27 28 1 1 1 1 1 1 26 27 28 1 1 1 61 62 63 73 74 63 63 65 66 1 1 6 7 8 
68 1 1 1 1 1 1 1 1 1 1 1 1 1 1 1 1 1 42 43 44 44 45 31 32 32 32 32 32 32 32 32 32 33 42 44 43 43 45 1 6 7 8 1 1 1 1 1 1 1 71 72 63 63 63 73 74 75 76 1 1 16 17 18 
78 1 1 1 1 1 1 1 1 1 1 1 1 1 1 1 1 51 52 53 54 53 53 56 1 42 43 44 44 43 43 45 1 42 52 53 53 54 55 56 16 17 18 1 1 1 1 1 1 1 61 62 63 73 74 63 63 65 76 1 1 26 27 28 
7 8 1 1 1 1 1 1 1 57 58 1 1 1 1 1 1 61 62 63 73 74 63 55 56 52 53 54 53 54 54 55 56 52 73 74 63 63 65 66 26 27 28 1 1 1 1 1 1 1 71 72 73 74 73 74 63 75 66 1 1 1 57 58 
17 18 6 7 8 1 1 1 1 67 68 1 1 57 58 1 1 71 72 63 63 63 73 74 54 53 63 63 63 63 63 63 54 53 63 63 73 74 75 76 6 7 8 1 1 1 1 11 13 1 81 82 83 84 84 83 84 85 86 1 1 1 67 68 
27 28 16 17 18 1 57 58 1 77 78 1 1 67 68 1 1 61 62 63 73 74 63 63 63 73 74 63 73 63 73 74 63 63 73 74 63 63 65 76 16 17 18 6 7 8 11 14 15 13 91 92 93 94 94 93 94 95 96 1 1 1 77 78 
8 1 26 27 28 1 67 68 1 1 1 1 1 77 78 1 1 71 72 73 74 73 74 63 73 74 73 73 74 73 74 73 74 63 74 73 74 63 75 66 26 27 28 16 17 18 31 24 25 33 101 102 103 104 102 103 104 105 106 1 1 1 57 58 
18 1 1 1 1 1 77 78 1 1 1 1 1 1 57 58 1 81 82 83 84 84 83 84 84 84 83 84 84 83 84 84 84 83 84 84 83 84 85 86 1 1 1 26 27 28 1 1 1 1 1 1 1 1 1 1 1 1 1 1 1 1 67 68 
28 1 1 1 1 1 1 1 1 1 57 58 1 1 67 68 1 91 92 93 94 94 93 94 94 94 93 94 94 93 94 94 94 93 94 94 93 94 95 96 1 1 1 1 1 1 1 1 6 7 8 1 1 1 1 1 1 6 7 8 1 1 77 78 
8 1 1 1 1 1 1 1 1 1 67 68 1 1 77 78 1 101 102 103 104 102 103 104 104 102 103 104 102 103 104 104 102 103 104 102 103 104 105 106 1 1 1 1 1 1 1 1 16 17 18 1 1 1 1 1 1 16 17 18 1 1 195 196 
18 1 1 1 1 57 58 6 7 8 77 78 1 1 1 1 1 1 1 1 1 1 1 1 1 1 1 1 1 1 1 1 1 1 1 1 1 1 1 1 1 1 1 1 1 1 1 1 26 27 28 1 1 1 1 1 1 26 27 28 1 1 205 206 
28 1 1 1 1 67 68 16 17 18 1 1 1 1 1 1 1 1 1 1 1 57 58 1 1 1 1 1 1 1 42 43 44 44 43 44 44 43 43 45 1 1 1 1 1 1 1 1 1 1 1 1 57 58 1 1 1 1 1 1 1 1 57 58 
7 8 57 58 1 77 78 26 27 28 1 1 1 1 1 1 1 1 1 1 1 67 68 1 1 1 1 1 1 51 52 53 54 53 53 54 53 53 54 55 56 1 1 1 57 58 57 58 1 1 1 1 67 68 1 1 1 1 1 1 1 1 67 68 
17 18 67 68 1 1 1 1 1 1 1 1 1 1 1 1 1 1 1 1 1 77 78 1 6 7 8 1 1 61 62 63 73 74 63 73 74 63 63 65 66 1 1 1 67 68 67 68 1 1 1 1 77 78 1 1 1 1 1 1 1 1 77 78 
27 28 77 78 1 1 1 1 1 1 1 1 1 1 42 43 44 44 43 43 45 1 1 1 16 17 18 1 1 71 72 63 63 63 73 63 63 73 74 75 76 1 1 1 77 78 77 78 1 1 1 1 1 1 1 1 42 43 44 44 43 43 45 1 
8 1 1 1 1 1 1 1 1 57 58 1 1 51 52 53 54 53 53 54 55 56 1 1 26 27 28 1 1 61 62 63 73 74 63 73 74 63 63 65 76 1 57 58 1 1 1 6 7 8 1 1 1 1 1 51 52 53 54 53 53 54 55 56 
18 1 6 7 8 1 1 1 1 67 68 1 1 61 62 63 73 74 63 63 65 66 1 1 1 1 1 1 1 71 72 73 74 73 74 74 73 74 63 75 66 1 67 68 1 57 58 16 17 18 1 1 1 1 1 61 62 63 73 74 63 63 65 66 
28 1 16 17 18 1 1 1 1 77 78 1 1 71 72 63 63 63 73 74 75 76 1 1 1 1 1 1 1 81 82 83 84 84 83 84 84 83 84 85 86 1 77 78 1 67 68 26 27 28 1 1 1 1 1 71 72 63 63 63 73 74 75 76 
8 1 26 27 28 1 1 57 58 1 1 1 1 61 62 63 73 74 63 63 65 76 1 1 1 1 1 1 1 91 92 93 94 94 93 94 94 93 94 95 96 1 1 1 1 77 78 1 1 1 1 1 1 1 1 61 62 63 73 74 63 63 65 76 
18 1 1 1 1 1 1 67 68 57 58 1 1 71 72 73 74 73 74 63 75 66 1 1 1 1 1 1 1 101 102 103 104 102 103 104 102 103 104 105 106 1 1 6 7 8 1 1 1 57 58 1 1 1 1 71 72 73 74 73 74 63 75 66 
28 1 57 58 1 1 1 77 78 67 68 1 1 81 82 83 84 84 83 84 85 86 6 7 8 1 1 1 1 1 1 1 1 1 1 1 1 1 1 1 1 1 1 16 17 18 1 1 1 67 68 1 6 7 8 81 82 83 84 84 83 84 85 86 
57 58 67 68 1 1 1 1 1 77 78 1 1 91 92 93 94 94 93 94 95 96 16 17 18 1 1 1 1 1 1 6 7 8 1 1 1 1 1 1 6 7 8 26 27 28 1 1 1 77 78 1 16 17 18 91 92 93 94 94 93 94 95 96 
67 68 77 78 6 7 8 6 7 8 6 7 8 101 102 103 104 102 103 104 105 106 26 27 28 6 7 8 6 7 8 16 17 18 6 7 8 6 7 8 16 17 18 6 7 8 6 7 8 6 7 8 26 27 28 101 102 103 104 102 103 104 105 106